1111111111111111
10C0000010000001
1000000011111111
100C000C00100001
1P0000E000000C01
100000C000100001
100C00A211111111
100000C010000001
1111111111111111
