1111111111111111
1000000010000001
1000000011111111
1000000000100001
1P00000000000C11
1000000000100001
1000000011111111
1000000010000001
1111111111111111
