1111111111111111
10C0000010000001
1000000011111111
100C001C00100001
1P0001E100000C01
1000001000100001
100C000011111111
100000C010000001
1111111111111111

