1111111111111111
10C00000100000010
100000001111111111111
100C000C001000010
1P0000E000000C01111
100000C00010000100000000
100C00001111111111111
100000C010000001011
1111111111111111001
