11111111111111111111111
10000000000010000000001
100C0000000010000000001
10000000000011111111111
10000C00000000010000001
10000000000000010000001
10000000000000010000001
10P00E00C00000000BC0001
10000000000000010000001
10C00000000000010000001
100000000C0000010000001
10000000000011111111111
1000C000000010000000001
10000000000010000000001
11111111111111111111111
